1111111111
100E000001
1001000011
1000000011
1000P00011
10C1000001
1111111111