11111111
111E0001
11010001
11111111
1110P111
11C10001
11111111