11111111111111111111111111111111
10000000C0000C000C00000001111111
10000111P0000000000000C00000E111
11111111100000000000000000000011
110000011111000001111111111C0011
100001111111000001100000000C1111
10111111100C00001111110000000001
10000111110000000000000000000001
100C00C0000000000011110000000001
10000000000100000000000100000001
100110000C0000000111111111100001
10000100000C0C000000011111111111
11111111111111111111111111111111