11111111
11100001
11E10001
11P11111
11100C11
11110011
11111111