11111111
11100001
11110001
11011111
11100111
11110011
11111111