11111111
11100001
11E10001
11P11111
11100C11
111100111
11111111