11111111111111111111111111111
10000000C0000C000C00001111111
10000111P0000000000C0E0000011
11111111100000000000000000011
11000001111100000111111111111
10000111111100000110000000001
10111111100C00001111110000001
10000111110000000000000000001
100C00C0000000000011110000001
10000000000100000000000100001
100110000C0000000111111111101
10000100000C0C000000011111111
11111111111111111111111111111