11111111111111111111111111111
10000000001111111111111111111
10000111P000000000000E0000011
11111111111111000000000000011
11000001111111111111111111111
10000111111111111110000000001
10111111111111111111110000001
10000111111111100000000000001
10000000000000000011110000001
10000000000100000000000100001
100110000C0000000111111111101
10000100000C00000000011111111
11111111111111111111111111111