111111111111
10000000E001
1C000P01111
111111111111