11111111111
10000000000
1000E00C001
1000P111111
11111111111