11111111111
1000E000011
1C000000011
10000000111
10000P00011
11111111111