1111111
1000E11
1C00011
1000111
1000P11
1111111