11111111111
1000C11E001
1000000P101
1A111111111